{
  "data":[
      [0, 0, 0, 0, 0, 0, 0, 0, 0, 0, 0, 0, 0, 0, 0, 0],
      [0, 0, 0, 0, 0, 0, 0, 0, 0, 0, 0, 0, 0, 0, 0, 0],
      [0, 0, 0, 0, 0, 0, 0, 0, 0, 0, 0, 0, 0, 0, 0, 0],
      [0, 0, 0, 0, 0, 0, 16, 16, 16, 16, 16, 0, 0, 0, 0, 0],
      [0, 0, 0, 0, 0, 0, 16, 2, 10, 2, 16, 0, 0, 0, 0, 0],
      [0, 0, 0, 0, 0, 0, 16, 2, 2, 2, 16, 0, 0, 0, 0, 0],
      [0, 0, 0, 0, 0, 0, 16, 2, 2, 2, 16, 0, 0, 0, 0, 0],
      [0, 0, 0, 0, 0, 0, 16, 2, 2, 2, 16, 0, 0, 0, 0, 0],
      [0, 0, 0, 0, 0, 0, 16, 2, 2, 2, 16, 0, 0, 0, 0, 0],
      [0, 0, 0, 0, 0, 0, 16, 2, 2, 2, 16, 0, 0, 0, 0, 0],
      [0, 0, 0, 0, 0, 0, 16, 2, 2, 2, 16, 0, 0, 0, 0, 0],
      [0, 0, 0, 0, 0, 0, 16, 2, 8, 2, 16, 0, 0, 0, 0, 0],
      [0, 0, 0, 0, 0, 0, 16, 16, 16, 16, 16, 0, 0, 0, 0, 0],
      [0, 0, 0, 0, 0, 0, 0, 0, 0, 0, 0, 0, 0, 0, 0, 0],
      [0, 0, 0, 0, 0, 0, 0, 0, 0, 0, 0, 0, 0, 0, 0, 0],
      [0, 0, 0, 0, 0, 0, 0, 0, 0, 0, 0, 0, 0, 0, 0, 0]
  ]
}