{
  "data":[
      [9,  3, 3, 3, 13, 14, 7,  1, 1, 1, 5,  5,  8,  2, 2, 2],
      [3,  3, 3, 3, 15, 16, 1,  1, 1, 1, 11, 11, 2,  2, 2, 2],
      [3,  3, 3, 3, 13, 14, 1,  1, 1, 1, 17, 17, 2,  2, 2, 2],
      [3,  3, 3, 3, 15, 16, 1,  1, 1, 1, 6,  6,  2,  2, 2, 2],
      [3,  3, 3, 3, 13, 14, 1,  1, 1, 1, 12, 12, 2,  2, 2, 2],
      [15, 3, 3, 3, 15, 16, 1,  1, 1, 1, 18, 18, 2,  2, 2, 2],
      [4,  4, 4, 4, 13, 14, 4,  4, 4, 4, 5,  5,  4,  4, 4, 4],
      [4,  4, 4, 4, 15, 16, 4,  4, 4, 4, 11, 11, 4,  4, 4, 4],
      [3,  3, 3, 3, 13, 14, 1,  1, 1, 1, 17, 17, 2,  2, 2, 2],
      [3,  3, 3, 3, 15, 16, 1,  1, 1, 1, 6,  6,  2,  2, 2, 2],
      [3,  3, 3, 3, 13, 14, 1,  1, 1, 1, 12, 12, 2,  2, 2, 2],
      [3,  3, 3, 3, 15, 16, 1,  1, 1, 1, 18, 18, 2,  2, 2, 2],
      [3,  3, 3, 3, 13, 14, 1,  1, 1, 1, 5,  5,  2,  2, 2, 2],
      [3,  3, 3, 3, 15, 16, 1,  1, 1, 1, 11, 11, 2,  2, 2, 2],
      [3,  3, 3, 3, 13, 14, 1,  1, 1, 1, 17, 17, 2,  2, 2, 2],
      [10, 3, 3, 3, 15, 16, 10, 1, 1, 1, 15, 16, 10, 2, 2, 2]
  ]
}